//MAP CONVERTED BY dmm2tgm.py THIS HEADER COMMENT PREVENTS RECONVERSION, DO NOT REMOVE
"a" = (
/turf/closed/mineral,
/area/template_noop)
"c" = (
/obj/structure/lattice,
/obj/structure/alien/weeds,
/turf/open/floor/plating/asteroid/airless,
/area/template_noop)
"d" = (
/obj/structure/alien/weeds/node,
/turf/open/floor/plasteel/airless,
/area/template_noop)
"e" = (
/obj/structure/alien/weeds,
/obj/structure/alien/resin/wall,
/turf/open/floor/plasteel/airless,
/area/template_noop)
"f" = (
/obj/structure/alien/weeds,
/mob/living/simple_animal/hostile/alien/drone{
	plants_off = 1
	},
/turf/open/floor/plating/asteroid/airless,
/area/template_noop)
"g" = (
/obj/effect/landmark/dropship_entry,
/turf/template_noop,
/area/template_noop)
"h" = (
/obj/structure/alien/weeds/node,
/obj/structure/alien/resin/membrane,
/turf/open/floor/plasteel/airless,
/area/template_noop)
"i" = (
/obj/structure/shuttle/engine/heater{
	dir = 1
	},
/turf/closed/wall/r_wall,
/area/template_noop)
"j" = (
/obj/structure/shuttle/engine/huge{
	dir = 1
	},
/turf/template_noop,
/area/template_noop)
"m" = (
/obj/structure/alien/weeds,
/obj/structure/alien/resin/membrane,
/turf/open/floor/plating/asteroid/airless,
/area/template_noop)
"n" = (
/obj/structure/alien/weeds,
/obj/structure/alien/weeds/node,
/obj/structure/alien/resin/membrane,
/turf/open/floor/plasteel/airless,
/area/template_noop)
"o" = (
/obj/structure/alien/weeds,
/obj/structure/alien/resin/membrane,
/turf/open/floor/plasteel/airless,
/area/template_noop)
"p" = (
/obj/structure/alien/weeds,
/obj/structure/alien/weeds/node,
/turf/open/floor/plating/asteroid/airless,
/area/template_noop)
"q" = (
/obj/structure/alien/weeds,
/mob/living/simple_animal/hostile/alien/sentinel,
/turf/open/floor/plasteel/airless,
/area/template_noop)
"r" = (
/obj/structure/lattice,
/obj/structure/firelock_frame/border{
	dir = 8
	},
/obj/structure/alien/weeds,
/obj/structure/alien/resin/membrane,
/turf/open/floor/plating/asteroid/airless,
/area/template_noop)
"s" = (
/obj/structure/lattice,
/turf/open/floor/plating/asteroid/airless,
/area/template_noop)
"t" = (
/turf/closed/wall/r_wall,
/area/template_noop)
"v" = (
/obj/structure/alien/weeds,
/obj/structure/alien/weeds,
/turf/open/floor/plasteel/airless,
/area/template_noop)
"w" = (
/obj/structure/alien/weeds,
/turf/open/floor/plating/asteroid/airless,
/area/template_noop)
"x" = (
/turf/open/floor/plasteel/airless,
/area/template_noop)
"y" = (
/obj/structure/firelock_frame/border{
	dir = 1
	},
/obj/structure/firelock_frame/border,
/obj/structure/alien/weeds,
/turf/open/floor/plasteel/airless,
/area/template_noop)
"z" = (
/obj/structure/alien/weeds,
/mob/living/simple_animal/hostile/alien,
/turf/open/floor/plasteel/airless,
/area/template_noop)
"A" = (
/obj/structure/lattice,
/obj/structure/lattice,
/obj/structure/firelock_frame/border{
	dir = 1
	},
/obj/structure/firelock_frame/border,
/obj/structure/alien/weeds,
/obj/structure/alien/weeds/node,
/obj/structure/alien/resin/membrane,
/turf/open/floor/plating/asteroid/airless,
/area/template_noop)
"C" = (
/obj/structure/alien/weeds/node,
/obj/structure/alien/resin/membrane,
/turf/open/floor/plating/asteroid/airless,
/area/template_noop)
"D" = (
/obj/structure/alien/weeds/node,
/obj/structure/alien/resin/wall,
/turf/open/floor/plasteel/airless,
/area/template_noop)
"E" = (
/obj/structure/firelock_frame/window,
/obj/structure/alien/weeds,
/turf/open/floor/plating/asteroid/airless,
/area/template_noop)
"F" = (
/obj/structure/alien/resin/membrane,
/turf/open/floor/plasteel/airless,
/area/template_noop)
"G" = (
/obj/structure/alien/weeds,
/obj/structure/alien/weeds/node,
/turf/open/floor/plasteel/airless,
/area/template_noop)
"H" = (
/obj/structure/alien/weeds,
/obj/structure/alien/resin,
/turf/open/floor/plasteel/airless,
/area/template_noop)
"I" = (
/obj/structure/firelock_frame/border{
	dir = 8
	},
/obj/structure/firelock_frame/border{
	dir = 4
	},
/obj/structure/alien/weeds,
/obj/structure/alien/resin/membrane,
/turf/open/floor/plasteel/airless,
/area/template_noop)
"K" = (
/obj/structure/lattice,
/obj/structure/alien/weeds,
/obj/structure/alien/resin/membrane,
/turf/open/floor/plating/asteroid/airless,
/area/template_noop)
"L" = (
/obj/structure/alien/weeds,
/obj/structure/alien/weeds,
/obj/structure/alien/resin/wall,
/turf/open/floor/plasteel/airless,
/area/template_noop)
"M" = (
/obj/structure/alien/weeds,
/obj/structure/alien/egg/burst,
/turf/open/floor/plasteel/airless,
/area/template_noop)
"O" = (
/obj/structure/alien/weeds/node,
/turf/open/floor/plating/asteroid/airless,
/area/template_noop)
"Q" = (
/obj/structure/alien/weeds,
/turf/open/floor/plasteel/airless,
/area/template_noop)
"R" = (
/turf/template_noop,
/area/template_noop)
"S" = (
/obj/structure/firelock_frame/window,
/turf/open/floor/plating/asteroid/airless,
/area/template_noop)
"T" = (
/obj/structure/lattice,
/obj/structure/firelock_frame/window,
/obj/structure/alien/weeds,
/turf/open/floor/plating/asteroid/airless,
/area/template_noop)
"U" = (
/obj/structure/firelock_frame/border{
	dir = 1
	},
/obj/structure/firelock_frame/border,
/obj/structure/alien/weeds,
/turf/open/floor/plating/asteroid/airless,
/area/template_noop)
"V" = (
/obj/structure/alien/weeds,
/obj/structure/alien/resin/wall,
/obj/structure/alien/resin/wall,
/turf/open/floor/plasteel/airless,
/area/template_noop)
"W" = (
/obj/structure/firelock_frame/window,
/obj/structure/alien/weeds,
/turf/open/floor/plasteel/airless,
/area/template_noop)
"X" = (
/obj/effect/decal/cleanable/xenoblood/xgibs/larva/body,
/obj/item/reagent_containers/food/snacks/burger/xeno,
/turf/open/floor/plasteel/airless,
/area/template_noop)
"Y" = (
/obj/structure/firelock_frame/border{
	dir = 8
	},
/obj/structure/firelock_frame/border{
	dir = 4
	},
/obj/structure/alien/weeds,
/turf/open/floor/plasteel/airless,
/area/template_noop)

(1,1,1) = {"
R
R
R
R
R
R
R
R
R
R
R
R
R
R
R
R
R
R
R
R
R
R
R
R
R
R
R
R
R
R
R
R
R
R
R
R
R
R
R
R
"}
(2,1,1) = {"
R
R
R
R
R
R
R
R
R
R
R
R
R
R
R
R
R
R
R
R
R
R
R
R
R
R
R
R
R
R
R
R
R
R
R
R
R
R
R
R
"}
(3,1,1) = {"
R
R
R
R
R
R
R
R
R
R
R
R
R
R
R
R
R
R
R
R
R
R
R
R
R
R
R
R
R
R
R
R
R
R
R
R
R
R
R
R
"}
(4,1,1) = {"
R
R
R
R
R
R
R
R
R
R
R
R
R
R
R
R
R
R
R
R
R
R
R
R
R
R
R
R
R
R
R
R
R
R
R
R
R
R
R
R
"}
(5,1,1) = {"
R
R
R
R
R
R
R
R
R
R
R
R
R
R
R
R
R
R
R
R
R
R
R
R
R
R
R
a
a
R
R
R
R
R
R
R
R
R
R
R
"}
(6,1,1) = {"
R
R
R
R
R
R
R
R
R
R
R
R
R
R
R
R
R
R
R
R
R
R
a
a
a
a
a
a
a
a
R
R
R
R
R
g
R
R
R
R
"}
(7,1,1) = {"
R
R
R
R
R
R
R
R
R
R
R
R
R
R
R
R
R
R
R
R
R
a
a
a
a
a
a
a
a
a
a
R
R
R
R
R
R
R
R
R
"}
(8,1,1) = {"
R
R
R
R
R
R
R
R
R
R
R
R
R
R
R
R
R
a
a
a
a
a
a
a
a
a
a
a
a
a
a
a
a
R
R
R
R
R
R
R
"}
(9,1,1) = {"
R
R
R
R
R
R
R
R
R
R
R
R
R
R
R
R
a
a
a
a
a
a
a
a
a
a
a
a
a
a
a
a
a
R
R
R
R
R
R
R
"}
(10,1,1) = {"
R
R
R
R
R
R
R
R
R
R
R
R
R
R
R
R
a
a
a
a
a
a
a
a
a
a
a
a
a
a
a
a
a
a
R
R
R
R
R
R
"}
(11,1,1) = {"
R
R
j
t
t
t
t
t
t
t
t
t
t
t
t
t
a
a
a
a
a
a
a
a
a
a
a
a
a
a
a
a
a
a
R
R
R
R
R
R
"}
(12,1,1) = {"
R
R
R
i
Q
Q
Q
Q
Q
Q
Q
o
Q
Q
Q
t
t
a
a
a
a
a
a
a
a
a
a
a
a
a
a
a
a
a
R
R
R
R
R
R
"}
(13,1,1) = {"
R
R
R
t
Q
d
Q
Q
Q
H
Q
o
Q
o
Q
Q
t
a
a
a
a
a
a
a
a
a
a
a
a
a
a
a
a
a
a
R
R
R
R
R
"}
(14,1,1) = {"
R
R
R
t
z
Q
Q
Q
Q
n
Q
o
Q
h
Q
Q
t
a
a
a
a
a
a
a
a
a
a
a
a
a
a
a
a
a
a
R
R
R
R
R
"}
(15,1,1) = {"
R
R
R
t
Q
Q
Q
Q
Q
H
Q
Q
Q
o
Q
Q
t
a
a
a
a
a
a
a
a
a
a
a
a
a
a
a
a
a
a
R
R
R
R
R
"}
(16,1,1) = {"
R
R
j
t
Q
Q
G
Q
Q
t
t
t
t
t
Q
t
t
t
t
t
t
t
t
t
K
a
a
a
w
a
a
a
a
a
a
a
R
R
R
R
"}
(17,1,1) = {"
R
R
R
i
Q
Q
Q
Q
Q
t
Q
Q
Q
G
Q
Q
v
G
t
x
x
x
x
Q
Q
S
a
c
w
a
a
a
a
a
a
a
R
R
R
R
"}
(18,1,1) = {"
R
R
R
t
t
t
t
t
t
t
Q
Q
Q
Q
Q
Q
Q
Q
t
x
s
s
Q
Q
c
A
w
X
w
w
O
a
a
a
a
a
a
R
R
R
"}
(19,1,1) = {"
R
R
R
R
R
R
R
R
R
t
Q
Q
Q
Q
Q
Q
Q
Q
t
x
x
x
s
Q
Q
t
K
E
w
a
a
a
a
a
a
a
a
R
R
R
"}
(20,1,1) = {"
R
R
R
R
R
R
R
R
j
t
Q
d
Q
Q
Q
d
Q
Q
t
t
t
t
t
Y
t
t
m
a
S
a
w
w
a
a
a
a
a
a
R
R
"}
(21,1,1) = {"
R
R
R
R
R
R
R
R
R
i
Q
Q
Q
Q
Q
Q
Q
Q
Q
d
e
L
e
Q
Q
U
f
F
c
w
O
a
a
a
a
a
a
a
R
R
"}
(22,1,1) = {"
R
R
R
R
R
R
R
R
R
t
t
t
t
Y
t
t
t
t
I
t
t
t
t
r
K
C
a
S
x
a
a
a
a
a
a
a
a
a
R
R
"}
(23,1,1) = {"
R
R
R
R
R
R
R
R
R
t
Q
Q
Q
Q
Q
Q
Q
Q
Q
Q
t
x
x
x
Q
c
w
w
w
a
a
a
a
a
a
a
a
a
a
R
"}
(24,1,1) = {"
R
R
j
t
t
t
t
t
t
t
Q
d
Q
Q
Q
d
Q
Q
Q
Q
t
x
s
x
Q
y
T
c
w
w
a
a
a
a
a
a
a
a
a
R
"}
(25,1,1) = {"
R
R
R
i
V
e
e
e
V
t
Q
Q
Q
Q
Q
Q
Q
Q
Q
d
t
x
x
Q
Q
W
w
a
a
a
a
a
a
a
a
a
a
a
a
R
"}
(26,1,1) = {"
R
R
R
t
Q
M
Q
Q
e
t
t
t
t
t
Q
t
t
t
t
t
t
t
t
t
w
c
p
Q
a
a
a
a
a
a
a
a
a
a
a
R
"}
(27,1,1) = {"
R
R
R
t
Q
d
Q
M
e
e
Q
Q
Q
e
Q
Q
t
a
a
a
a
a
a
a
a
a
w
a
a
a
a
a
a
a
a
a
a
a
a
R
"}
(28,1,1) = {"
R
R
R
t
Q
Q
Q
Q
Q
e
Q
e
Q
D
e
Q
t
a
a
a
a
a
a
a
a
a
a
a
a
a
a
a
a
a
a
a
a
a
a
R
"}
(29,1,1) = {"
R
R
j
t
M
Q
q
Q
Q
d
Q
e
Q
e
Q
Q
t
a
a
a
a
a
a
a
a
a
a
a
a
a
a
a
a
a
a
a
a
a
a
R
"}
(30,1,1) = {"
R
R
R
i
Q
M
Q
Q
e
e
Q
e
Q
Q
Q
t
t
a
a
a
a
a
a
a
a
a
a
a
a
a
a
a
a
a
a
a
a
a
a
R
"}
(31,1,1) = {"
R
R
R
t
t
t
t
t
t
t
t
t
t
t
t
t
a
a
a
a
a
a
a
a
a
a
a
a
a
a
a
a
a
a
a
a
a
a
R
R
"}
(32,1,1) = {"
R
R
R
R
R
R
R
R
R
a
a
a
a
a
a
a
a
a
a
a
a
a
a
a
a
a
a
a
a
a
a
a
a
a
a
a
R
R
R
R
"}
(33,1,1) = {"
R
R
R
R
R
R
R
R
a
a
a
a
a
a
a
a
a
a
a
a
a
a
a
a
a
a
a
a
a
a
a
a
a
a
a
R
R
R
R
R
"}
(34,1,1) = {"
R
R
R
R
R
R
R
R
a
a
a
a
a
a
a
a
a
a
a
a
a
a
a
a
a
a
a
a
R
R
R
R
R
R
R
R
R
R
R
R
"}
(35,1,1) = {"
R
R
R
R
R
R
R
R
a
a
a
a
a
a
a
a
a
a
a
a
a
a
a
a
a
R
R
R
R
R
R
R
R
R
R
R
R
R
R
R
"}
(36,1,1) = {"
R
R
R
R
R
R
R
R
R
a
a
a
a
a
a
a
a
a
a
R
R
R
R
R
R
R
R
R
R
R
R
R
R
R
R
R
R
R
R
R
"}
(37,1,1) = {"
R
R
R
R
R
R
R
R
R
R
a
a
a
a
a
a
a
a
R
R
R
R
R
R
R
R
R
R
R
R
R
R
R
R
R
R
R
R
R
R
"}
(38,1,1) = {"
R
R
R
R
R
R
R
R
R
R
R
a
a
a
a
a
R
R
R
R
R
R
R
R
R
R
R
R
R
R
R
R
R
R
R
R
R
R
R
R
"}
(39,1,1) = {"
R
R
R
R
R
R
R
R
R
R
R
R
R
R
R
R
R
R
R
R
R
R
R
R
R
R
R
R
R
R
R
R
R
R
R
R
R
R
R
R
"}
(40,1,1) = {"
R
R
R
R
R
R
R
R
R
R
R
R
R
R
R
R
R
R
R
R
R
R
R
R
R
R
R
R
R
R
R
R
R
R
R
R
R
R
R
R
"}
