//MAP CONVERTED BY dmm2tgm.py THIS HEADER COMMENT PREVENTS RECONVERSION, DO NOT REMOVE
"a" = (
/turf/closed/mineral,
/area/space)
"c" = (
/obj/structure/table,
/turf/open/floor/monotile/steel,
/area/space)
"d" = (
/obj/effect/decal/cleanable/blood/gibs/torso,
/turf/open/floor/monotile/steel,
/area/space)
"h" = (
/obj/machinery/light/small{
	bulb_colour = "#FF0000";
	bulb_emergency_colour = "#FF0000";
	bulb_vacuum_colour = "#FF0000";
	nightshift_light_color = "#FF0000";
	dir = 5
	},
/turf/open/floor/monotile/steel,
/area/space)
"i" = (
/obj/effect/mob_spawn/human/corpse/pirate,
/obj/effect/decal/cleanable/blood,
/turf/open/floor/monotile/steel,
/area/space)
"j" = (
/obj/effect/mob_spawn/human/corpse/cargo_tech,
/obj/effect/decal/cleanable/blood,
/turf/open/floor/monotile/steel,
/area/space)
"k" = (
/obj/machinery/door/airlock/ship/external/glass,
/obj/effect/mapping_helpers/airlock/cyclelink_helper{
	dir = 4
	},
/obj/effect/decal/cleanable/blood/tracks{
	dir = 4
	},
/turf/open/floor/plating,
/area/space)
"m" = (
/obj/effect/mob_spawn/human/corpse/assistant,
/obj/effect/decal/cleanable/blood,
/turf/open/floor/monotile/steel,
/area/space)
"q" = (
/turf/open/floor/monotile/steel,
/area/space)
"t" = (
/obj/machinery/light/small{
	dir = 8;
	pixel_y = 10;
	bulb_colour = "#FF0000";
	bulb_emergency_colour = "#FF0000";
	bulb_vacuum_colour = "#FF0000";
	nightshift_light_color = "#FF0000"
	},
/turf/open/floor/monotile/steel,
/area/space)
"u" = (
/obj/effect/landmark/dropship_entry,
/turf/template_noop,
/area/space)
"y" = (
/turf/closed/wall/r_wall/ship,
/area/space)
"A" = (
/obj/effect/decal/cleanable/blood/gibs/down,
/turf/open/floor/monotile/steel,
/area/space)
"C" = (
/obj/effect/decal/cleanable/blood/tracks{
	dir = 4
	},
/turf/open/floor/monotile/steel,
/area/space)
"D" = (
/obj/effect/decal/cleanable/blood/gibs,
/turf/open/floor/monotile/steel,
/area/space)
"I" = (
/obj/effect/mob_spawn/human/clown/corpse,
/obj/effect/decal/cleanable/blood,
/turf/open/floor/monotile/steel,
/area/space)
"J" = (
/obj/effect/decal/cleanable/blood/gibs/up,
/turf/open/floor/monotile/steel,
/area/space)
"O" = (
/obj/machinery/light/small{
	dir = 4;
	bulb_colour = "#FF0000";
	bulb_emergency_colour = "#FF0000";
	bulb_vacuum_colour = "#FF0000";
	nightshift_light_color = "#FF0000"
	},
/turf/open/floor/monotile/steel,
/area/space)
"P" = (
/turf/template_noop,
/area/space)
"Q" = (
/obj/effect/decal/cleanable/blood/gibs/core,
/turf/open/floor/monotile/steel,
/area/space)
"R" = (
/obj/structure/table,
/obj/item/toy/redbutton{
	desc = "A big, plastic red button. Used to call emergency meetings."
	},
/obj/structure/displaycase,
/turf/open/floor/monotile/steel,
/area/space)
"T" = (
/obj/effect/mob_spawn/human/corpse/russian,
/obj/effect/decal/cleanable/blood,
/turf/open/floor/monotile/steel,
/area/space)
"V" = (
/obj/machinery/light/small{
	dir = 1;
	bulb_colour = "#FF0000";
	bulb_emergency_colour = "#FF0000";
	bulb_vacuum_colour = "#FF0000";
	nightshift_light_color = "#FF0000"
	},
/turf/open/floor/monotile/steel,
/area/space)
"W" = (
/obj/effect/decal/cleanable/blood/tracks{
	dir = 4
	},
/obj/machinery/light/small{
	dir = 1
	},
/turf/open/floor/plating,
/area/space)
"X" = (
/obj/structure/table,
/obj/structure/table,
/turf/open/floor/monotile/steel,
/area/space)
"Y" = (
/obj/machinery/door/airlock/ship/external/glass,
/obj/effect/mapping_helpers/airlock/cyclelink_helper{
	dir = 8
	},
/obj/effect/decal/cleanable/blood/tracks{
	dir = 4
	},
/turf/open/floor/plating,
/area/space)

(1,1,1) = {"
P
P
P
P
P
P
P
P
P
P
P
P
P
P
P
P
P
P
P
P
P
P
P
P
P
P
P
P
P
P
P
P
P
P
P
P
P
P
P
P
"}
(2,1,1) = {"
P
P
P
P
P
P
P
P
P
P
P
P
P
P
P
P
P
P
P
P
P
P
P
P
P
P
P
P
P
P
P
P
P
P
P
P
P
P
P
P
"}
(3,1,1) = {"
P
P
P
P
P
P
P
P
P
P
P
P
P
P
P
P
P
P
P
P
P
P
P
P
P
P
P
P
P
P
P
P
P
P
P
P
P
P
P
P
"}
(4,1,1) = {"
P
P
P
P
P
P
P
P
P
P
P
P
P
P
P
P
P
P
P
P
P
P
P
P
P
P
P
P
P
P
P
P
P
P
P
P
P
P
P
P
"}
(5,1,1) = {"
P
P
P
P
P
P
P
P
P
P
P
P
P
P
P
P
P
P
P
P
P
P
P
P
P
P
P
P
P
P
P
P
P
P
P
P
P
P
P
P
"}
(6,1,1) = {"
P
P
P
P
P
P
P
P
P
P
P
P
P
P
P
P
P
P
P
P
P
P
P
P
P
P
P
P
P
P
P
P
P
P
P
u
P
P
P
P
"}
(7,1,1) = {"
P
P
P
P
P
P
P
P
P
P
P
P
P
P
P
P
P
P
a
a
a
a
a
a
a
a
a
a
a
a
P
P
P
P
P
P
P
P
P
P
"}
(8,1,1) = {"
P
P
P
P
P
P
P
P
P
a
a
P
P
P
P
a
P
a
a
a
a
a
a
a
a
a
a
a
a
a
a
P
P
P
P
P
P
P
P
P
"}
(9,1,1) = {"
P
P
P
P
P
P
P
P
a
a
a
a
a
a
a
a
a
a
a
a
a
a
a
a
a
a
a
a
a
a
a
a
P
P
P
P
P
P
P
P
"}
(10,1,1) = {"
P
P
P
P
P
P
P
P
a
a
a
a
a
a
a
a
a
a
a
a
a
a
a
a
a
a
a
a
a
a
a
a
a
a
P
P
P
P
P
P
"}
(11,1,1) = {"
P
P
P
P
P
P
P
P
a
a
a
a
a
a
a
a
a
a
a
a
a
a
a
a
a
a
a
a
a
a
a
a
a
a
a
P
P
P
P
P
"}
(12,1,1) = {"
P
P
P
P
P
P
P
P
P
a
a
a
a
a
a
a
a
a
a
a
a
a
a
a
a
a
a
a
a
a
a
a
a
a
a
a
a
P
P
P
"}
(13,1,1) = {"
P
P
P
P
P
P
P
P
P
a
a
a
a
a
a
a
a
a
a
a
a
a
a
a
a
a
a
a
a
a
a
a
a
a
a
a
a
a
a
P
"}
(14,1,1) = {"
P
P
P
P
P
P
P
P
P
P
a
a
a
a
a
a
a
a
a
a
a
a
a
a
a
a
a
a
a
a
a
a
a
a
a
a
a
a
a
P
"}
(15,1,1) = {"
P
P
P
P
P
P
P
P
P
P
a
a
a
a
a
a
a
a
a
a
a
a
a
a
a
a
a
a
a
a
a
a
a
a
a
a
a
a
a
P
"}
(16,1,1) = {"
P
P
P
P
P
P
P
P
P
P
a
a
a
a
a
a
a
a
a
a
a
y
y
y
y
y
y
y
a
a
a
a
a
a
a
a
a
a
a
P
"}
(17,1,1) = {"
P
P
P
P
P
P
P
P
P
P
a
a
a
a
a
a
a
a
a
a
y
y
A
q
t
q
q
y
y
a
a
a
a
a
a
a
a
a
a
P
"}
(18,1,1) = {"
P
P
P
P
P
P
P
P
P
P
a
a
a
a
a
a
a
a
a
y
y
q
q
q
I
q
q
D
y
y
a
a
a
a
a
a
a
a
a
P
"}
(19,1,1) = {"
P
P
P
P
P
P
P
P
P
P
a
a
a
a
a
a
a
a
a
y
Q
q
m
c
c
c
i
q
q
y
a
a
a
a
a
a
a
a
a
P
"}
(20,1,1) = {"
P
P
P
P
P
P
P
P
P
P
a
a
a
a
a
a
a
a
a
y
q
j
c
X
c
c
c
q
q
y
a
a
a
a
a
a
a
a
a
P
"}
(21,1,1) = {"
P
P
P
P
P
P
P
P
P
P
P
a
a
a
a
a
a
a
a
y
V
q
c
c
R
c
c
T
h
y
a
a
a
a
a
a
a
a
a
P
"}
(22,1,1) = {"
P
P
P
P
P
P
P
P
P
P
P
a
a
a
a
a
a
a
a
y
q
q
c
X
c
X
c
q
q
y
a
a
a
a
a
a
a
a
P
P
"}
(23,1,1) = {"
P
P
P
P
P
P
P
P
P
P
P
P
a
a
a
a
a
a
a
y
q
q
m
c
c
c
q
J
q
y
a
a
a
a
a
a
a
P
P
P
"}
(24,1,1) = {"
P
P
P
P
P
P
P
P
P
P
P
P
P
a
a
a
a
a
a
y
y
q
q
q
m
q
q
q
y
y
a
a
a
a
a
a
a
P
P
P
"}
(25,1,1) = {"
P
P
P
P
P
P
P
P
P
P
P
P
P
a
a
a
a
a
a
a
y
y
d
O
C
O
q
y
y
a
a
a
a
a
a
a
P
P
P
P
"}
(26,1,1) = {"
P
P
P
P
P
P
P
P
P
P
P
P
P
a
a
a
a
a
a
a
a
y
y
y
k
y
y
y
a
a
a
a
a
a
a
a
P
P
P
P
"}
(27,1,1) = {"
P
P
P
P
P
P
P
P
P
P
P
P
P
P
a
a
a
a
a
a
a
a
a
y
W
y
a
a
a
a
a
a
a
a
a
a
P
P
P
P
"}
(28,1,1) = {"
P
P
P
P
P
P
P
P
P
P
P
P
P
P
P
a
a
a
a
a
a
a
a
y
Y
y
a
a
a
a
a
a
a
a
a
a
P
P
P
P
"}
(29,1,1) = {"
P
P
P
P
P
P
P
P
P
P
P
P
P
P
P
a
a
a
a
a
a
a
a
a
a
a
a
a
a
a
a
a
a
a
a
a
a
P
P
P
"}
(30,1,1) = {"
P
P
P
P
P
P
P
P
P
P
P
P
P
P
P
a
a
a
a
a
a
a
a
a
a
a
a
a
a
a
a
a
a
a
a
a
a
P
P
P
"}
(31,1,1) = {"
P
P
P
P
P
P
P
P
P
P
P
P
P
P
P
P
a
a
a
a
a
a
a
a
a
a
a
a
a
a
a
a
a
a
a
a
a
P
P
P
"}
(32,1,1) = {"
P
P
P
P
P
P
P
P
P
P
P
P
P
P
P
P
P
a
a
a
a
a
a
a
a
a
a
a
a
a
a
a
a
a
a
a
P
P
P
P
"}
(33,1,1) = {"
P
P
P
P
P
P
P
P
P
P
P
P
P
P
P
P
P
P
P
P
a
a
a
a
a
a
a
a
a
a
a
a
a
a
a
P
P
P
P
P
"}
(34,1,1) = {"
P
P
P
P
P
P
P
P
P
P
P
P
P
P
P
P
P
P
P
P
P
P
P
a
a
a
a
a
a
a
a
a
a
a
P
P
P
P
P
P
"}
(35,1,1) = {"
P
P
P
P
P
P
P
P
P
P
P
P
P
P
P
P
P
P
P
P
P
P
P
P
P
a
a
a
a
a
a
a
a
P
P
P
P
P
P
P
"}
(36,1,1) = {"
P
P
P
P
P
P
P
P
P
P
P
P
P
P
P
P
P
P
P
P
P
P
P
P
P
P
P
P
P
a
a
P
P
P
P
P
P
P
P
P
"}
(37,1,1) = {"
P
P
P
P
P
P
P
P
P
P
P
P
P
P
P
P
P
P
P
P
P
P
P
P
P
P
P
P
P
P
P
P
P
P
P
P
P
P
P
P
"}
(38,1,1) = {"
P
P
P
P
P
P
P
P
P
P
P
P
P
P
P
P
P
P
P
P
P
P
P
P
P
P
P
P
P
P
P
P
P
P
P
P
P
P
P
P
"}
(39,1,1) = {"
P
P
P
P
P
P
P
P
P
P
P
P
P
P
P
P
P
P
P
P
P
P
P
P
P
P
P
P
P
P
P
P
P
P
P
P
P
P
P
P
"}
(40,1,1) = {"
P
P
P
P
P
P
P
P
P
P
P
P
P
P
P
P
P
P
P
P
P
P
P
P
P
P
P
P
P
P
P
P
P
P
P
P
P
P
P
P
"}
