//MAP CONVERTED BY dmm2tgm.py THIS HEADER COMMENT PREVENTS RECONVERSION, DO NOT REMOVE
"a" = (
/turf/template_noop,
/area/template_noop)
"c" = (
/obj/structure/closet/secure_closet/engineering_welding{
	anchored = 1;
	name = "pitstop locker";
	req_access = null;
	req_one_access_txt = "48"
	},
/turf/open/floor/plating/asteroid/airless,
/area/ruin/powered)
"d" = (
/obj/effect/decal/cleanable/blood/footprints{
	dir = 8
	},
/turf/open/floor/wood,
/area/ruin/powered)
"e" = (
/obj/machinery/vending/boozeomat,
/turf/open/floor/carpet/royalblack,
/area/ruin/powered)
"f" = (
/obj/structure/fighter_frame/utility,
/turf/open/floor/plating/asteroid/airless,
/area/ruin/powered)
"g" = (
/obj/structure/lattice/catwalk,
/obj/effect/decal/cleanable/blood/footprints{
	dir = 6
	},
/turf/open/floor/plating/asteroid/airless,
/area/ruin/powered)
"h" = (
/turf/closed/mineral,
/area/ruin/powered)
"i" = (
/obj/structure/railing{
	dir = 4;
	layer = 2.91
	},
/obj/machinery/portable_atmospherics/canister/oxygen,
/turf/open/floor/wood,
/area/ruin/powered)
"j" = (
/obj/effect/decal/cleanable/blood,
/obj/item/broken_bottle,
/turf/open/floor/wood,
/area/ruin/powered)
"k" = (
/obj/structure/table/wood,
/obj/machinery/chem_dispenser/drinks/beer{
	dir = 8
	},
/turf/open/floor/carpet/royalblack,
/area/ruin/powered)
"m" = (
/obj/effect/mapping_helpers/airlock/cyclelink_helper{
	dir = 1
	},
/obj/machinery/door/airlock/ship/external/glass,
/obj/effect/decal/cleanable/blood/footprints{
	dir = 6
	},
/turf/open/floor/plating,
/area/ruin/powered)
"n" = (
/obj/structure/lattice/catwalk,
/obj/structure/lattice/catwalk,
/turf/template_noop,
/area/template_noop)
"o" = (
/obj/effect/landmark/dropship_entry,
/turf/template_noop,
/area/template_noop)
"p" = (
/obj/structure/chair/wood/normal{
	dir = 4
	},
/turf/open/floor/carpet/royalblack,
/area/ruin/powered)
"q" = (
/obj/structure/table/wood/fancy/royalblue,
/obj/effect/spawner/lootdrop/ruinloot/important,
/obj/item/fighter_component/engine/tier2,
/turf/open/floor/carpet/royalblack,
/area/ruin/powered)
"r" = (
/obj/effect/mapping_helpers/airlock/cyclelink_helper,
/obj/machinery/door/airlock/ship/external/glass,
/obj/effect/decal/cleanable/blood/footprints{
	dir = 6
	},
/turf/open/floor/plating,
/area/ruin/powered)
"s" = (
/obj/structure/lattice,
/turf/open/floor/plating/asteroid/airless,
/area/ruin/powered)
"t" = (
/obj/structure/table/wood/fancy/royalblack,
/obj/item/reagent_containers/food/drinks/shaker{
	pixel_x = 4
	},
/obj/item/reagent_containers/food/drinks/bottle/rum{
	pixel_x = -4;
	pixel_y = 2
	},
/turf/open/floor/carpet/royalblack,
/area/ruin/powered)
"u" = (
/turf/open/floor/carpet/royalblack,
/area/ruin/powered)
"x" = (
/obj/machinery/light/small{
	dir = 1
	},
/turf/open/floor/carpet/royalblack,
/area/ruin/powered)
"z" = (
/obj/structure/lattice/catwalk,
/turf/open/floor/plating/asteroid/airless,
/area/ruin/powered)
"B" = (
/obj/machinery/light/small{
	dir = 8
	},
/obj/effect/decal/cleanable/blood/footprints{
	dir = 6
	},
/turf/open/floor/plating,
/area/ruin/powered)
"C" = (
/obj/structure/table/wood/fancy/royalblack,
/obj/effect/spawner/lootdrop/maintenance/five,
/turf/open/floor/carpet/royalblack,
/area/ruin/powered)
"G" = (
/obj/structure/chair/wood/normal,
/turf/open/floor/carpet/royalblack,
/area/ruin/powered)
"H" = (
/obj/structure/chair/wood/normal{
	dir = 6
	},
/turf/open/floor/carpet/royalblack,
/area/ruin/powered)
"I" = (
/obj/structure/chair/wood/normal{
	dir = 8
	},
/mob/living/simple_animal/hostile/pirate/melee/space,
/turf/open/floor/carpet/royalblack,
/area/ruin/powered)
"J" = (
/obj/structure/railing{
	dir = 4;
	layer = 2.91
	},
/obj/machinery/light/small,
/obj/structure/tank_dispenser/oxygen,
/turf/open/floor/wood,
/area/ruin/powered)
"K" = (
/obj/structure/table/wood,
/obj/machinery/chem_dispenser/drinks{
	dir = 8
	},
/turf/open/floor/carpet/royalblack,
/area/ruin/powered)
"L" = (
/obj/structure/lattice/catwalk,
/turf/template_noop,
/area/template_noop)
"M" = (
/obj/effect/decal/cleanable/blood/footprints{
	dir = 6
	},
/turf/open/floor/wood,
/area/ruin/powered)
"N" = (
/mob/living/simple_animal/hostile/pirate/melee/space,
/turf/open/floor/carpet/royalblack,
/area/ruin/powered)
"O" = (
/obj/effect/spawner/structure/window/reinforced/ship,
/turf/open/floor/plating,
/area/ruin/powered)
"R" = (
/turf/open/floor/plating/asteroid/airless,
/area/ruin/powered)
"S" = (
/obj/structure/table/wood/fancy/royalblack,
/obj/item/stack/spacecash/c100{
	pixel_x = 4;
	pixel_y = 10
	},
/obj/item/stack/spacecash/c20{
	pixel_y = 6;
	pixel_x = 2
	},
/obj/item/stack/spacecash/c10{
	pixel_y = 2
	},
/turf/open/floor/carpet/royalblack,
/area/ruin/powered)
"T" = (
/turf/closed/wall/r_wall/ship,
/area/ruin/powered)
"U" = (
/obj/structure/table/wood/fancy/royalblue,
/obj/machinery/light/small{
	brightness = 3;
	dir = 8
	},
/obj/item/fighter_component/apu/tier3,
/turf/open/floor/carpet/royalblack,
/area/ruin/powered)
"V" = (
/obj/structure/chair/wood/normal{
	dir = 8
	},
/obj/machinery/light/small{
	dir = 4
	},
/turf/open/floor/carpet/royalblack,
/area/ruin/powered)
"W" = (
/obj/structure/lattice,
/turf/template_noop,
/area/template_noop)
"X" = (
/obj/structure/table/wood/fancy/royalblack,
/obj/item/trash/candle{
	pixel_y = 8
	},
/turf/open/floor/carpet/royalblack,
/area/ruin/powered)
"Z" = (
/obj/structure/reagent_dispensers/fueltank/cryogenic_fuel,
/turf/open/floor/plating/asteroid/airless,
/area/ruin/powered)

(1,1,1) = {"
a
a
a
a
a
a
a
a
a
a
a
a
a
a
a
a
a
a
a
a
a
a
a
a
a
a
a
a
a
a
a
a
a
a
a
a
a
a
a
a
"}
(2,1,1) = {"
a
a
a
a
a
a
a
a
a
a
a
a
a
a
a
a
a
a
a
a
a
a
a
a
a
a
a
a
a
a
a
a
a
a
a
a
a
a
a
a
"}
(3,1,1) = {"
a
a
a
a
a
a
a
a
a
a
a
a
a
a
a
a
a
a
a
a
a
a
a
a
a
a
a
a
a
a
a
a
a
a
a
a
a
a
a
a
"}
(4,1,1) = {"
a
a
a
a
a
a
a
a
a
a
a
a
a
a
a
a
a
a
a
a
a
a
a
a
a
a
a
a
a
a
a
a
a
a
a
a
a
a
a
a
"}
(5,1,1) = {"
a
a
a
a
a
a
a
a
a
a
a
a
a
a
a
a
a
a
a
a
a
a
a
a
a
a
a
a
a
a
a
a
a
a
a
a
a
a
a
a
"}
(6,1,1) = {"
a
a
a
a
a
a
a
a
a
a
a
a
a
a
a
a
h
h
h
a
a
a
a
a
a
a
a
a
a
a
a
a
a
a
a
o
a
a
a
a
"}
(7,1,1) = {"
a
a
a
a
a
a
a
a
a
a
a
a
a
a
a
h
h
h
h
a
a
a
a
a
a
a
h
h
h
h
h
a
a
a
a
a
a
a
a
a
"}
(8,1,1) = {"
a
a
a
a
a
a
a
a
a
a
a
a
h
h
h
h
h
h
h
h
a
a
a
a
a
h
h
h
h
h
h
h
h
a
a
a
a
a
a
a
"}
(9,1,1) = {"
a
a
a
a
a
a
a
a
a
a
a
h
h
h
h
h
h
h
h
h
W
a
W
W
W
h
h
h
h
h
h
h
h
a
a
a
a
a
a
a
"}
(10,1,1) = {"
a
a
a
a
a
a
a
a
a
a
h
h
h
h
h
h
h
h
h
h
a
a
a
a
a
h
h
h
h
h
h
h
h
h
a
a
a
a
a
a
"}
(11,1,1) = {"
a
a
a
a
a
a
a
a
a
h
h
h
h
h
h
h
h
h
h
h
a
a
a
a
a
h
h
h
h
h
h
h
h
h
a
a
a
a
a
a
"}
(12,1,1) = {"
a
a
a
a
a
a
a
a
a
h
h
h
h
h
h
h
h
h
h
h
h
W
W
a
W
h
h
h
h
h
h
h
h
a
a
a
a
a
a
a
"}
(13,1,1) = {"
a
a
a
a
a
a
a
a
h
h
h
h
h
h
h
h
h
h
h
h
h
a
a
a
a
h
h
h
h
h
h
h
h
a
a
a
a
a
a
a
"}
(14,1,1) = {"
a
a
a
a
a
a
a
a
h
h
h
h
h
h
h
h
h
h
h
h
h
a
a
a
a
h
h
h
h
h
h
h
h
h
a
a
a
a
a
a
"}
(15,1,1) = {"
a
a
a
a
a
a
a
a
h
h
h
h
h
h
h
h
h
h
h
h
h
a
a
a
a
W
R
h
h
h
h
h
h
h
a
a
a
a
a
a
"}
(16,1,1) = {"
a
a
a
a
a
a
a
a
a
h
h
h
h
h
h
h
h
h
h
h
R
a
a
a
a
W
R
h
h
h
h
h
h
h
a
a
a
a
a
a
"}
(17,1,1) = {"
a
a
a
a
a
a
a
a
h
h
h
h
h
h
h
h
h
h
h
h
R
a
a
a
a
a
R
h
h
h
h
h
h
h
a
a
a
a
a
a
"}
(18,1,1) = {"
a
a
a
a
a
a
a
h
h
h
h
h
h
h
h
h
h
h
h
R
R
a
a
a
a
a
R
R
h
h
h
h
h
h
a
a
a
a
a
a
"}
(19,1,1) = {"
a
a
a
a
a
a
a
h
h
h
h
h
h
h
h
h
h
h
h
R
R
a
a
a
a
W
R
R
c
h
h
h
h
h
h
a
a
a
a
a
"}
(20,1,1) = {"
a
a
a
a
a
a
a
h
h
h
h
h
h
h
h
h
h
h
h
R
R
R
a
a
a
W
R
R
R
h
h
h
h
h
h
a
a
a
a
a
"}
(21,1,1) = {"
a
a
a
a
a
a
h
h
h
h
h
h
T
T
T
T
T
T
T
z
z
z
L
L
L
L
z
z
z
h
h
h
h
h
h
a
a
a
a
a
"}
(22,1,1) = {"
a
a
a
a
a
a
h
h
h
h
h
h
T
d
M
M
r
B
m
g
g
g
L
L
L
L
z
z
z
h
h
h
h
h
h
h
a
a
a
a
"}
(23,1,1) = {"
a
a
a
a
a
h
h
h
h
h
h
h
T
j
i
J
T
T
T
z
z
z
n
L
L
L
z
z
z
h
h
h
h
h
h
h
a
a
a
a
"}
(24,1,1) = {"
a
a
a
a
a
h
h
h
h
h
h
h
T
u
u
u
G
U
O
s
s
R
W
W
W
W
s
R
Z
h
h
h
h
h
h
h
a
a
a
a
"}
(25,1,1) = {"
a
a
a
a
a
h
h
h
h
h
h
h
T
u
u
u
u
I
O
R
s
R
a
a
a
W
R
R
Z
h
h
h
h
h
h
h
a
a
a
a
"}
(26,1,1) = {"
a
a
a
a
a
a
h
h
h
h
h
h
T
X
S
C
u
p
O
R
s
a
a
a
a
W
R
f
h
h
h
h
h
h
h
a
a
a
a
a
"}
(27,1,1) = {"
a
a
a
a
a
a
h
h
h
h
h
h
T
u
N
t
H
q
O
R
R
a
a
a
a
W
R
R
h
h
h
h
h
h
h
a
a
a
a
a
"}
(28,1,1) = {"
a
a
a
a
a
a
h
h
h
h
h
h
T
x
u
u
u
V
O
R
R
a
a
a
a
W
R
h
h
h
h
h
h
h
h
a
a
a
a
a
"}
(29,1,1) = {"
a
a
a
a
a
a
a
a
a
h
h
h
T
k
K
e
T
T
T
h
R
a
a
a
a
h
h
h
h
h
h
h
h
h
a
a
a
a
a
a
"}
(30,1,1) = {"
a
a
a
a
a
a
a
a
a
a
a
h
T
T
T
T
T
h
h
h
h
W
W
W
W
h
h
h
h
h
h
a
a
a
a
a
a
a
a
a
"}
(31,1,1) = {"
a
a
a
a
a
a
a
a
a
a
a
h
h
h
h
h
h
h
h
h
a
a
a
a
a
a
h
h
h
h
h
a
a
a
a
a
a
a
a
a
"}
(32,1,1) = {"
a
a
a
a
a
a
a
a
a
a
a
a
h
h
h
h
h
h
h
h
a
a
a
a
a
a
h
h
h
h
a
a
a
a
a
a
a
a
a
a
"}
(33,1,1) = {"
a
a
a
a
a
a
a
a
a
a
a
a
a
a
h
h
h
h
h
h
W
W
a
W
W
a
h
h
h
a
a
a
a
a
a
a
a
a
a
a
"}
(34,1,1) = {"
a
a
a
a
a
a
a
a
a
a
a
a
a
a
a
h
h
h
h
h
a
a
a
a
a
a
h
h
a
a
a
a
a
a
a
a
a
a
a
a
"}
(35,1,1) = {"
a
a
a
a
a
a
a
a
a
a
a
a
a
a
a
a
h
h
h
a
a
a
a
a
a
a
a
a
a
a
a
a
a
a
a
a
a
a
a
a
"}
(36,1,1) = {"
a
a
a
a
a
a
a
a
a
a
a
a
a
a
a
a
a
a
a
a
a
a
a
a
a
a
a
a
a
a
a
a
a
a
a
a
a
a
a
a
"}
(37,1,1) = {"
a
a
a
a
a
a
a
a
a
a
a
a
a
a
a
a
a
a
a
a
a
a
a
a
a
a
a
a
a
a
a
a
a
a
a
a
a
a
a
a
"}
(38,1,1) = {"
a
a
a
a
a
a
a
a
a
a
a
a
a
a
a
a
a
a
a
a
a
a
a
a
a
a
a
a
a
a
a
a
a
a
a
a
a
a
a
a
"}
(39,1,1) = {"
a
a
a
a
a
a
a
a
a
a
a
a
a
a
a
a
a
a
a
a
a
a
a
a
a
a
a
a
a
a
a
a
a
a
a
a
a
a
a
a
"}
(40,1,1) = {"
a
a
a
a
a
a
a
a
a
a
a
a
a
a
a
a
a
a
a
a
a
a
a
a
a
a
a
a
a
a
a
a
a
a
a
a
a
a
a
a
"}
