//MAP CONVERTED BY dmm2tgm.py THIS HEADER COMMENT PREVENTS RECONVERSION, DO NOT REMOVE
"a" = (
/turf/closed/mineral,
/area/ruin/powered)
"c" = (
/turf/open/floor/plating/asteroid/airless,
/area/ruin/powered)
"j" = (
/obj/machinery/ai_slipper,
/turf/open/floor/monotile/dark,
/area/ruin/powered)
"l" = (
/obj/machinery/recharge_station,
/turf/open/floor/circuit/red/anim,
/area/ruin/powered)
"m" = (
/obj/machinery/porta_turret/syndicate/energy,
/obj/effect/turf_decal/stripes/box,
/turf/open/floor/monotile/dark,
/area/ruin/powered)
"o" = (
/obj/structure/table/reinforced,
/obj/effect/spawner/lootdrop/ruinloot/science,
/obj/effect/spawner/lootdrop/aimodule_harmful,
/turf/open/floor/circuit/red/anim,
/area/ruin/powered)
"p" = (
/turf/template_noop,
/area/template_noop)
"s" = (
/obj/structure/sign/poster/contraband/free_drone,
/turf/closed/wall/r_wall/ship,
/area/ruin/powered)
"t" = (
/obj/item/aiModule/toyAI,
/obj/item/aiModule/core/full/antimov,
/turf/open/floor/monotile/dark,
/area/ruin/powered)
"u" = (
/obj/structure/table/reinforced,
/obj/effect/spawner/lootdrop/ruinloot/science,
/obj/effect/spawner/lootdrop/aimodule_neutral,
/turf/open/floor/circuit/red/anim,
/area/ruin/powered)
"v" = (
/obj/machinery/flasher{
	id = "hopflash";
	pixel_x = -28;
	pixel_y = -28
	},
/obj/machinery/holopad,
/turf/open/floor/monotile/dark,
/area/ruin/powered)
"x" = (
/obj/machinery/light/small,
/turf/open/floor/monotile/dark,
/area/ruin/powered)
"y" = (
/obj/machinery/camera/autoname{
	dir = 1
	},
/turf/open/floor/circuit/red/anim,
/area/ruin/powered)
"A" = (
/obj/machinery/light/small{
	dir = 1
	},
/turf/open/floor/circuit/red/anim,
/area/ruin/powered)
"C" = (
/obj/machinery/door/airlock/ship/hatch/glass,
/obj/effect/mapping_helpers/airlock/cyclelink_helper{
	dir = 4
	},
/turf/open/floor/monotile/dark,
/area/ruin/powered)
"D" = (
/obj/machinery/door/airlock/ship/hatch/glass,
/obj/effect/mapping_helpers/airlock/cyclelink_helper{
	dir = 8
	},
/turf/open/floor/monotile/dark,
/area/ruin/powered)
"F" = (
/obj/structure/table/reinforced,
/obj/item/robot_module/borgi,
/turf/open/floor/circuit/red/anim,
/area/ruin/powered)
"L" = (
/turf/open/floor/circuit/red/anim,
/area/ruin/powered)
"M" = (
/obj/structure/table/reinforced,
/obj/effect/spawner/lootdrop/ruinloot/science,
/obj/effect/spawner/lootdrop/aimodule_harmless,
/turf/open/floor/circuit/red/anim,
/area/ruin/powered)
"R" = (
/turf/open/floor/monotile/dark,
/area/ruin/powered)
"S" = (
/obj/machinery/light/small{
	dir = 1
	},
/turf/open/floor/monotile/dark,
/area/ruin/powered)
"Z" = (
/turf/closed/wall/r_wall/ship,
/area/ruin/powered)

(1,1,1) = {"
p
p
p
p
p
p
p
p
p
p
p
p
p
p
p
p
p
p
p
p
p
p
p
p
p
p
p
p
p
p
p
p
p
p
p
p
p
p
p
p
"}
(2,1,1) = {"
p
p
p
p
p
p
p
p
p
p
p
p
p
p
p
p
p
p
p
p
p
p
p
p
p
p
p
p
p
p
p
p
p
p
p
p
p
p
p
p
"}
(3,1,1) = {"
p
p
p
p
p
p
p
p
p
p
p
p
p
p
p
p
p
p
p
p
p
p
p
p
p
p
p
p
p
p
p
p
p
p
p
p
p
p
p
p
"}
(4,1,1) = {"
p
p
p
p
p
p
p
p
p
p
p
p
p
p
p
p
p
p
p
p
p
p
p
p
p
p
p
p
p
p
p
p
p
p
p
p
p
p
p
p
"}
(5,1,1) = {"
p
p
p
p
p
p
p
p
p
p
p
p
p
p
p
p
p
p
p
p
p
p
p
p
p
p
p
p
p
p
p
p
p
p
p
p
p
p
p
p
"}
(6,1,1) = {"
p
p
p
p
p
p
p
p
p
p
p
p
p
p
p
p
p
p
p
p
p
p
p
p
p
p
p
p
p
p
p
p
p
p
p
p
p
p
p
p
"}
(7,1,1) = {"
p
p
p
p
p
p
p
p
p
p
p
p
p
p
p
p
p
a
a
a
p
p
p
p
p
p
p
p
p
p
p
p
p
p
p
p
p
p
p
p
"}
(8,1,1) = {"
p
p
p
p
p
p
p
p
p
p
p
p
p
p
p
a
a
a
a
a
a
a
a
p
p
p
p
p
p
p
p
p
p
p
p
p
p
p
p
p
"}
(9,1,1) = {"
p
p
p
p
p
p
p
p
p
p
p
p
p
p
a
a
a
a
a
a
a
a
a
a
a
p
p
p
p
p
p
p
p
p
p
p
p
p
p
p
"}
(10,1,1) = {"
p
p
p
p
p
p
p
p
p
p
a
a
a
a
a
a
a
a
a
a
a
a
a
a
a
a
a
a
a
a
a
p
p
p
p
p
p
p
p
p
"}
(11,1,1) = {"
p
p
p
p
p
p
p
p
p
p
a
a
a
a
a
a
a
a
a
a
a
a
a
a
a
a
a
a
a
a
a
a
a
a
a
p
p
p
p
p
"}
(12,1,1) = {"
p
p
p
p
p
p
p
p
p
p
a
a
a
a
a
a
a
a
a
a
a
a
a
a
a
a
a
a
a
a
a
a
a
a
a
p
p
p
p
p
"}
(13,1,1) = {"
p
p
p
p
p
p
p
p
p
a
a
a
a
a
a
a
a
a
a
a
a
a
a
a
a
a
a
a
a
a
a
a
a
a
a
p
p
p
p
p
"}
(14,1,1) = {"
p
p
p
p
p
p
p
p
p
a
a
a
a
a
a
a
a
a
a
a
a
a
a
a
a
a
a
a
a
a
a
a
a
a
a
p
p
p
p
p
"}
(15,1,1) = {"
p
p
p
p
p
p
p
p
p
a
a
a
a
a
a
a
a
a
a
a
a
a
a
a
a
a
a
a
a
a
a
a
a
a
a
a
a
p
p
p
"}
(16,1,1) = {"
p
p
p
p
p
p
p
p
p
a
a
a
a
a
a
a
a
a
a
a
a
a
a
a
a
a
a
a
a
a
a
a
a
a
a
a
a
a
p
p
"}
(17,1,1) = {"
p
p
p
p
p
p
p
p
p
a
a
a
a
a
a
a
a
a
a
a
a
a
a
a
a
a
a
a
a
a
a
a
a
a
a
a
a
a
p
p
"}
(18,1,1) = {"
p
p
p
p
p
p
p
p
p
a
a
a
a
a
a
a
Z
Z
Z
Z
Z
Z
Z
Z
Z
a
a
a
a
a
a
a
a
a
a
a
a
a
p
p
"}
(19,1,1) = {"
p
p
p
p
p
p
p
p
p
a
a
a
a
a
a
a
Z
L
L
Z
Z
Z
L
L
Z
a
a
a
a
a
a
a
a
a
a
a
a
a
p
p
"}
(20,1,1) = {"
p
p
p
p
p
p
p
p
p
a
a
a
a
a
a
a
Z
L
x
Z
t
Z
S
L
Z
a
a
a
a
a
a
a
a
a
a
a
a
a
p
p
"}
(21,1,1) = {"
p
p
p
p
p
p
p
p
p
a
a
a
a
a
a
a
Z
L
R
m
v
m
R
L
Z
a
a
a
a
a
a
a
a
a
a
a
a
a
p
p
"}
(22,1,1) = {"
p
p
p
p
p
p
p
p
p
a
a
a
a
a
a
a
Z
M
R
R
j
R
R
o
Z
a
a
a
a
a
a
a
a
a
a
a
a
a
p
p
"}
(23,1,1) = {"
p
p
p
p
p
p
p
p
p
a
a
a
a
a
a
a
Z
u
L
L
R
L
L
F
Z
a
a
a
a
a
a
a
a
a
a
a
a
a
p
p
"}
(24,1,1) = {"
p
p
p
p
p
p
p
p
p
a
a
a
a
a
a
a
Z
Z
Z
Z
C
Z
Z
Z
Z
a
a
a
a
a
a
a
a
a
a
a
a
a
p
p
"}
(25,1,1) = {"
p
p
p
p
p
p
p
p
p
a
a
a
a
a
a
a
a
a
Z
l
R
L
Z
a
a
a
a
a
a
a
a
a
a
a
a
a
a
a
p
p
"}
(26,1,1) = {"
p
p
p
p
p
p
p
p
p
p
a
a
a
a
a
a
a
a
Z
A
R
y
Z
a
a
a
a
a
a
a
a
a
a
a
a
a
a
a
p
p
"}
(27,1,1) = {"
p
p
p
p
p
p
p
p
p
p
p
a
a
a
a
a
a
a
Z
s
D
s
Z
c
a
a
a
a
a
a
a
a
a
a
a
a
a
p
p
p
"}
(28,1,1) = {"
p
p
p
p
p
p
p
p
p
p
p
a
a
a
a
a
a
c
c
c
c
c
c
c
a
a
a
a
a
a
a
a
a
a
a
a
a
p
p
p
"}
(29,1,1) = {"
p
p
p
p
p
p
p
p
p
p
a
a
a
a
a
a
a
a
c
c
c
c
c
a
a
a
a
a
a
a
a
a
a
a
a
a
a
p
p
p
"}
(30,1,1) = {"
p
p
p
p
p
p
p
p
p
p
p
a
a
a
a
a
a
a
a
c
a
a
c
c
a
a
a
a
a
a
a
a
a
a
a
a
p
p
p
p
"}
(31,1,1) = {"
p
p
p
p
p
p
p
p
p
p
p
p
p
a
a
a
a
a
a
a
a
a
a
a
a
a
a
a
a
a
a
a
a
a
a
a
p
p
p
p
"}
(32,1,1) = {"
p
p
p
p
p
p
p
p
p
p
p
p
p
p
a
a
a
a
a
a
a
a
a
a
a
a
a
a
a
a
a
a
a
a
a
a
p
p
p
p
"}
(33,1,1) = {"
p
p
p
p
p
p
p
p
p
p
p
p
p
p
p
a
a
a
a
a
a
a
a
a
a
a
a
a
a
a
a
a
a
a
a
a
p
p
p
p
"}
(34,1,1) = {"
p
p
p
p
p
p
p
p
p
p
p
p
p
p
p
p
a
a
a
a
a
a
a
a
a
a
a
a
a
a
a
a
a
a
a
p
p
p
p
p
"}
(35,1,1) = {"
p
p
p
p
p
p
p
p
p
p
p
p
p
p
p
p
p
p
p
p
a
a
a
a
a
a
a
a
a
a
p
p
p
p
p
p
p
p
p
p
"}
(36,1,1) = {"
p
p
p
p
p
p
p
p
p
p
p
p
p
p
p
p
p
p
p
p
p
p
p
a
a
a
a
a
a
p
p
p
p
p
p
p
p
p
p
p
"}
(37,1,1) = {"
p
p
p
p
p
p
p
p
p
p
p
p
p
p
p
p
p
p
p
p
p
p
p
p
p
p
p
p
p
p
p
p
p
p
p
p
p
p
p
p
"}
(38,1,1) = {"
p
p
p
p
p
p
p
p
p
p
p
p
p
p
p
p
p
p
p
p
p
p
p
p
p
p
p
p
p
p
p
p
p
p
p
p
p
p
p
p
"}
(39,1,1) = {"
p
p
p
p
p
p
p
p
p
p
p
p
p
p
p
p
p
p
p
p
p
p
p
p
p
p
p
p
p
p
p
p
p
p
p
p
p
p
p
p
"}
(40,1,1) = {"
p
p
p
p
p
p
p
p
p
p
p
p
p
p
p
p
p
p
p
p
p
p
p
p
p
p
p
p
p
p
p
p
p
p
p
p
p
p
p
p
"}
