//MAP CONVERTED BY dmm2tgm.py THIS HEADER COMMENT PREVENTS RECONVERSION, DO NOT REMOVE
"bl" = (
/obj/structure/alien/weeds,
/obj/machinery/door/airlock/ship/engineering/glass{
	req_one_access_txt = "10;24"
	},
/obj/machinery/door/firedoor/border_only{
	dir = 4
	},
/obj/machinery/door/firedoor/border_only{
	dir = 8
	},
/turf/open/floor/plasteel/airless,
/area/ruin/powered)
"bs" = (
/obj/structure/table/reinforced,
/turf/open/floor/plasteel/airless,
/area/ruin/powered)
"ce" = (
/obj/structure/alien/weeds,
/obj/structure/alien/resin/wall,
/obj/structure/alien/resin/wall,
/turf/open/floor/plasteel/airless,
/area/ruin/powered)
"ck" = (
/obj/structure/alien/weeds,
/obj/structure/reagent_dispensers/fueltank,
/obj/item/weldingtool,
/turf/open/floor/plasteel/airless,
/area/ruin/powered)
"cI" = (
/obj/structure/alien/weeds,
/obj/structure/table,
/turf/open/floor/plasteel/airless,
/area/ruin/powered)
"en" = (
/obj/structure/firelock_frame/border{
	dir = 1
	},
/obj/structure/firelock_frame/border,
/obj/structure/alien/weeds,
/turf/open/floor/plating/asteroid/airless,
/area/ruin/powered)
"eo" = (
/obj/structure/lattice,
/obj/structure/firelock_frame/window,
/obj/structure/alien/weeds,
/turf/open/floor/plating/asteroid/airless,
/area/ruin/powered)
"eT" = (
/obj/structure/alien/resin/membrane,
/turf/open/floor/plasteel/airless,
/area/ruin/powered)
"gB" = (
/obj/structure/alien/weeds,
/turf/open/floor/plating,
/area/ruin/powered)
"ii" = (
/obj/structure/alien/weeds/node,
/obj/structure/alien/resin/wall,
/turf/open/floor/plasteel/airless,
/area/ruin/powered)
"iv" = (
/obj/structure/alien/weeds,
/obj/structure/closet/crate/bin,
/turf/open/floor/plasteel/airless,
/area/ruin/powered)
"iS" = (
/obj/structure/lattice,
/obj/structure/alien/weeds,
/obj/structure/alien/resin/membrane,
/turf/open/floor/plating/asteroid/airless,
/area/ruin/powered)
"jc" = (
/obj/structure/alien/weeds,
/obj/structure/girder/displaced,
/turf/open/floor/plating/asteroid/airless,
/area/ruin/powered)
"ks" = (
/obj/structure/lattice,
/obj/structure/lattice,
/obj/structure/firelock_frame/border{
	dir = 1
	},
/obj/structure/firelock_frame/border,
/obj/structure/alien/weeds,
/obj/structure/alien/weeds/node,
/obj/structure/alien/resin/membrane,
/turf/open/floor/plating/asteroid/airless,
/area/ruin/powered)
"lj" = (
/obj/structure/shuttle/engine/heater{
	dir = 1
	},
/turf/closed/wall/r_wall,
/area/ruin/powered)
"lF" = (
/obj/structure/alien/weeds,
/obj/structure/girder/displaced,
/turf/open/floor/plasteel/airless,
/area/ruin/powered)
"lW" = (
/obj/structure/lattice,
/obj/structure/firelock_frame/border{
	dir = 8
	},
/obj/structure/alien/weeds,
/obj/structure/alien/resin/membrane,
/turf/open/floor/plating/asteroid/airless,
/area/ruin/powered)
"nH" = (
/obj/structure/alien/weeds,
/obj/structure/alien/resin/wall,
/turf/open/floor/plating,
/area/ruin/powered)
"ow" = (
/obj/structure/alien/weeds/node,
/obj/structure/alien/resin/membrane,
/turf/open/floor/plasteel/airless,
/area/ruin/powered)
"oF" = (
/obj/structure/lattice,
/obj/structure/alien/weeds,
/turf/open/floor/plating/asteroid/airless,
/area/ruin/powered)
"pA" = (
/obj/structure/lattice,
/obj/structure/alien/weeds,
/obj/structure/girder/displaced,
/turf/open/floor/plating/asteroid/airless,
/area/ruin/powered)
"pV" = (
/obj/structure/alien/weeds,
/obj/effect/mob_spawn/human/corpse/pirate,
/turf/open/floor/plating/asteroid/airless,
/area/ruin/powered)
"qq" = (
/obj/structure/alien/weeds,
/obj/structure/table,
/obj/item/storage/box/donkpockets{
	pixel_x = 4;
	pixel_y = 6
	},
/obj/item/reagent_containers/food/drinks/beer{
	pixel_x = -6;
	pixel_y = 6
	},
/obj/item/reagent_containers/food/drinks/beer{
	pixel_x = -10;
	pixel_y = 7
	},
/obj/item/reagent_containers/food/drinks/beer{
	pixel_x = -8;
	pixel_y = 4
	},
/turf/open/floor/plasteel/airless,
/area/ruin/powered)
"sY" = (
/obj/structure/alien/weeds,
/turf/open/floor/plating/asteroid/airless,
/area/ruin/powered)
"tf" = (
/obj/structure/alien/weeds,
/obj/structure/alien/weeds/node,
/turf/open/floor/plating/asteroid/airless,
/area/ruin/powered)
"tM" = (
/turf/closed/mineral,
/area/ruin/powered)
"uM" = (
/obj/structure/alien/weeds,
/mob/living/simple_animal/hostile/alien/drone{
	plants_off = 1
	},
/turf/open/floor/plating/asteroid/airless,
/area/ruin/powered)
"uU" = (
/obj/structure/alien/weeds,
/obj/structure/table,
/obj/item/disk/tech_disk/research/random,
/turf/open/floor/plasteel/airless,
/area/ruin/powered)
"vb" = (
/obj/structure/alien/weeds,
/obj/machinery/power/port_gen/pacman,
/turf/open/floor/plasteel/airless,
/area/ruin/powered)
"wv" = (
/obj/structure/firelock_frame/window,
/obj/structure/alien/weeds,
/turf/open/floor/plasteel/airless,
/area/ruin/powered)
"xT" = (
/obj/structure/firelock_frame/border{
	dir = 8
	},
/obj/structure/firelock_frame/border{
	dir = 4
	},
/obj/structure/alien/weeds,
/obj/structure/alien/resin/membrane,
/turf/open/floor/plasteel/airless,
/area/ruin/powered)
"yV" = (
/obj/structure/alien/weeds,
/mob/living/simple_animal/hostile/alien,
/turf/open/floor/plasteel/airless,
/area/ruin/powered)
"zt" = (
/obj/structure/alien/weeds,
/obj/structure/table/reinforced,
/turf/open/floor/plasteel/airless,
/area/ruin/powered)
"zU" = (
/obj/structure/alien/weeds,
/obj/machinery/power/port_gen/pacman/mrs,
/turf/open/floor/plasteel/airless,
/area/ruin/powered)
"AZ" = (
/obj/structure/alien/weeds,
/obj/structure/table,
/obj/machinery/microwave{
	pixel_y = 6;
	pixel_x = -1
	},
/turf/open/floor/plasteel/airless,
/area/ruin/powered)
"Bm" = (
/obj/structure/alien/weeds/node,
/obj/structure/table,
/turf/open/floor/plasteel/airless,
/area/ruin/powered)
"BB" = (
/obj/structure/alien/weeds,
/obj/structure/table,
/obj/structure/table,
/turf/open/floor/plasteel/airless,
/area/ruin/powered)
"BF" = (
/obj/structure/alien/weeds/node,
/obj/structure/alien/resin/membrane,
/turf/open/floor/plating/asteroid/airless,
/area/ruin/powered)
"BS" = (
/obj/structure/table,
/obj/item/disk/tech_disk/research/random,
/turf/open/floor/plasteel/airless,
/area/ruin/powered)
"CD" = (
/obj/structure/lattice,
/obj/structure/alien/weeds,
/obj/item/flamethrower/full,
/turf/open/floor/plating/asteroid/airless,
/area/ruin/powered)
"DF" = (
/obj/structure/alien/weeds,
/obj/structure/alien/resin/membrane,
/turf/open/floor/plasteel/airless,
/area/ruin/powered)
"DI" = (
/obj/structure/alien/weeds,
/obj/structure/alien/resin,
/turf/open/floor/plasteel/airless,
/area/ruin/powered)
"DS" = (
/obj/structure/alien/weeds,
/obj/item/broken_bottle,
/turf/open/floor/plasteel/airless,
/area/ruin/powered)
"DV" = (
/obj/structure/firelock_frame/window,
/obj/structure/alien/weeds,
/turf/open/floor/plating/asteroid/airless,
/area/ruin/powered)
"Ej" = (
/obj/structure/table/reinforced,
/obj/item/storage/toolbox/emergency,
/turf/open/floor/plasteel/airless,
/area/ruin/powered)
"Fh" = (
/obj/structure/alien/weeds,
/obj/structure/alien/resin/membrane,
/turf/open/floor/plating/asteroid/airless,
/area/ruin/powered)
"FC" = (
/obj/structure/alien/weeds,
/obj/structure/alien/egg/burst,
/turf/open/floor/plasteel/airless,
/area/ruin/powered)
"Gs" = (
/obj/structure/alien/weeds,
/obj/structure/alien/weeds/node,
/turf/open/floor/plasteel/airless,
/area/ruin/powered)
"Iu" = (
/obj/structure/alien/weeds,
/obj/structure/alien/weeds/node,
/obj/structure/alien/resin/membrane,
/turf/open/floor/plasteel/airless,
/area/ruin/powered)
"IE" = (
/obj/structure/alien/weeds,
/obj/machinery/power/port_gen/pacman/super,
/turf/open/floor/plasteel/airless,
/area/ruin/powered)
"IT" = (
/turf/open/floor/plasteel/airless,
/area/ruin/powered)
"IX" = (
/obj/structure/firelock_frame/border{
	dir = 1
	},
/obj/structure/firelock_frame/border,
/obj/structure/alien/weeds,
/turf/open/floor/plasteel/airless,
/area/ruin/powered)
"Jd" = (
/obj/structure/alien/weeds,
/obj/structure/table/reinforced,
/obj/item/storage/toolbox/electrical{
	pixel_y = 8
	},
/obj/item/storage/toolbox/mechanical,
/turf/open/floor/plasteel/airless,
/area/ruin/powered)
"LU" = (
/obj/effect/landmark/dropship_entry,
/turf/template_noop,
/area/template_noop)
"Nb" = (
/obj/structure/alien/weeds,
/turf/open/floor/plasteel/airless,
/area/ruin/powered)
"Nc" = (
/obj/structure/alien/weeds/node,
/turf/open/floor/plasteel/airless,
/area/ruin/powered)
"No" = (
/obj/effect/decal/cleanable/xenoblood/xgibs/larva/body,
/obj/item/reagent_containers/food/snacks/burger/xeno,
/turf/open/floor/plasteel/airless,
/area/ruin/powered)
"Nq" = (
/obj/structure/alien/weeds,
/obj/structure/alien/weeds,
/turf/open/floor/plasteel/airless,
/area/ruin/powered)
"Om" = (
/obj/structure/lattice,
/turf/open/floor/plating/asteroid/airless,
/area/ruin/powered)
"OC" = (
/obj/structure/alien/weeds,
/obj/structure/alien/weeds,
/obj/structure/alien/resin/wall,
/turf/open/floor/plasteel/airless,
/area/ruin/powered)
"OP" = (
/obj/structure/alien/weeds/node,
/turf/open/floor/plating/asteroid/airless,
/area/ruin/powered)
"PG" = (
/turf/closed/wall/r_wall,
/area/ruin/powered)
"QA" = (
/obj/structure/shuttle/engine/huge{
	dir = 1
	},
/turf/template_noop,
/area/template_noop)
"QQ" = (
/obj/structure/firelock_frame/window,
/turf/open/floor/plating/asteroid/airless,
/area/ruin/powered)
"Uw" = (
/obj/structure/alien/weeds,
/obj/structure/alien/resin/wall,
/turf/open/floor/plasteel/airless,
/area/ruin/powered)
"Vw" = (
/obj/structure/alien/weeds,
/mob/living/simple_animal/hostile/alien/sentinel,
/turf/open/floor/plasteel/airless,
/area/ruin/powered)
"Wy" = (
/obj/structure/alien/weeds,
/obj/structure/tank_dispenser/plasma,
/turf/open/floor/plasteel/airless,
/area/ruin/powered)
"WY" = (
/obj/structure/alien/weeds,
/obj/structure/alien/weeds/node,
/obj/structure/table,
/turf/open/floor/plasteel/airless,
/area/ruin/powered)
"Xp" = (
/turf/template_noop,
/area/template_noop)
"Yn" = (
/obj/structure/firelock_frame/border{
	dir = 8
	},
/obj/structure/firelock_frame/border{
	dir = 4
	},
/obj/structure/alien/weeds,
/turf/open/floor/plasteel/airless,
/area/ruin/powered)

(1,1,1) = {"
Xp
Xp
Xp
Xp
Xp
Xp
Xp
Xp
Xp
Xp
Xp
Xp
Xp
Xp
Xp
Xp
Xp
Xp
Xp
Xp
Xp
Xp
Xp
Xp
Xp
Xp
Xp
Xp
Xp
Xp
Xp
Xp
Xp
Xp
Xp
Xp
Xp
Xp
Xp
Xp
"}
(2,1,1) = {"
Xp
Xp
Xp
Xp
Xp
Xp
Xp
Xp
Xp
Xp
Xp
Xp
Xp
Xp
Xp
Xp
Xp
Xp
Xp
Xp
Xp
Xp
Xp
Xp
Xp
Xp
Xp
Xp
Xp
Xp
Xp
Xp
Xp
Xp
Xp
Xp
Xp
Xp
Xp
Xp
"}
(3,1,1) = {"
Xp
Xp
Xp
Xp
Xp
Xp
Xp
Xp
Xp
Xp
Xp
Xp
Xp
Xp
Xp
Xp
Xp
Xp
Xp
Xp
Xp
Xp
Xp
Xp
Xp
Xp
Xp
Xp
Xp
Xp
Xp
Xp
Xp
Xp
Xp
Xp
Xp
Xp
Xp
Xp
"}
(4,1,1) = {"
Xp
Xp
Xp
Xp
Xp
Xp
Xp
Xp
Xp
Xp
Xp
Xp
Xp
Xp
Xp
Xp
Xp
Xp
Xp
Xp
Xp
Xp
Xp
Xp
Xp
Xp
Xp
Xp
Xp
Xp
Xp
Xp
Xp
Xp
Xp
Xp
Xp
Xp
Xp
Xp
"}
(5,1,1) = {"
Xp
Xp
Xp
Xp
Xp
Xp
Xp
Xp
Xp
Xp
Xp
Xp
Xp
Xp
Xp
Xp
Xp
Xp
Xp
Xp
Xp
Xp
Xp
Xp
Xp
Xp
Xp
tM
tM
Xp
Xp
Xp
Xp
Xp
Xp
Xp
Xp
Xp
Xp
Xp
"}
(6,1,1) = {"
Xp
Xp
Xp
Xp
Xp
Xp
Xp
Xp
Xp
Xp
Xp
Xp
Xp
Xp
Xp
Xp
Xp
Xp
Xp
Xp
Xp
Xp
tM
tM
tM
tM
tM
tM
tM
tM
Xp
Xp
Xp
Xp
Xp
LU
Xp
Xp
Xp
Xp
"}
(7,1,1) = {"
Xp
Xp
Xp
Xp
Xp
Xp
Xp
Xp
Xp
Xp
Xp
Xp
Xp
Xp
Xp
Xp
Xp
Xp
Xp
Xp
Xp
tM
tM
tM
tM
tM
tM
tM
tM
tM
tM
Xp
Xp
Xp
Xp
Xp
Xp
Xp
Xp
Xp
"}
(8,1,1) = {"
Xp
Xp
Xp
Xp
Xp
Xp
Xp
Xp
Xp
Xp
Xp
Xp
Xp
Xp
Xp
Xp
Xp
tM
tM
tM
tM
tM
tM
tM
tM
tM
tM
tM
tM
tM
tM
tM
tM
Xp
Xp
Xp
Xp
Xp
Xp
Xp
"}
(9,1,1) = {"
Xp
Xp
Xp
Xp
Xp
Xp
Xp
Xp
Xp
Xp
Xp
Xp
Xp
Xp
Xp
Xp
tM
tM
tM
tM
tM
tM
tM
tM
tM
tM
tM
tM
tM
tM
tM
tM
tM
Xp
Xp
Xp
Xp
Xp
Xp
Xp
"}
(10,1,1) = {"
Xp
Xp
Xp
Xp
Xp
Xp
Xp
Xp
Xp
Xp
Xp
Xp
Xp
Xp
Xp
Xp
tM
tM
tM
tM
tM
tM
tM
tM
tM
tM
tM
tM
tM
tM
tM
tM
tM
tM
Xp
Xp
Xp
Xp
Xp
Xp
"}
(11,1,1) = {"
Xp
Xp
QA
PG
PG
PG
PG
PG
PG
PG
PG
PG
PG
PG
PG
PG
tM
tM
tM
tM
tM
tM
tM
tM
tM
tM
tM
tM
tM
tM
tM
tM
tM
tM
Xp
Xp
Xp
Xp
Xp
Xp
"}
(12,1,1) = {"
Xp
Xp
Xp
lj
Nb
Nb
Nb
Nb
Nb
Nb
Nb
DF
Nb
Nb
Nb
PG
PG
tM
tM
tM
tM
tM
tM
tM
tM
tM
tM
tM
tM
tM
tM
tM
tM
tM
Xp
Xp
Xp
Xp
Xp
Xp
"}
(13,1,1) = {"
Xp
Xp
Xp
PG
Nb
Nc
Nb
Nb
Nb
DI
Nb
DF
Nb
DF
Nb
Nb
PG
tM
tM
tM
tM
tM
tM
tM
tM
tM
tM
tM
tM
tM
tM
tM
tM
tM
tM
Xp
Xp
Xp
Xp
Xp
"}
(14,1,1) = {"
Xp
Xp
Xp
PG
yV
Nb
Nb
Nb
Nb
Iu
Nb
DF
Nb
ow
Nb
Nb
PG
tM
tM
tM
tM
tM
tM
tM
tM
tM
tM
tM
tM
tM
tM
tM
tM
tM
tM
Xp
Xp
Xp
Xp
Xp
"}
(15,1,1) = {"
Xp
Xp
Xp
PG
Nb
Nb
Nb
Nb
Nb
DI
Nb
Nb
Nb
DF
Nb
Nb
PG
tM
tM
tM
tM
tM
tM
tM
tM
tM
tM
tM
tM
tM
tM
tM
tM
tM
tM
Xp
Xp
Xp
Xp
Xp
"}
(16,1,1) = {"
Xp
Xp
QA
PG
Nb
Nb
Gs
Nb
Nb
PG
PG
PG
PG
PG
Nb
PG
PG
PG
PG
PG
PG
PG
PG
PG
iS
tM
tM
tM
sY
tM
tM
tM
tM
tM
tM
tM
Xp
Xp
Xp
Xp
"}
(17,1,1) = {"
Xp
Xp
Xp
lj
Nb
Nb
Nb
Nb
Nb
PG
cI
Nb
cI
WY
Nb
Nb
Nq
Gs
PG
IT
IT
IT
BS
uU
cI
QQ
tM
CD
pV
tM
tM
tM
tM
tM
tM
tM
Xp
Xp
Xp
Xp
"}
(18,1,1) = {"
Xp
Xp
Xp
PG
PG
PG
PG
PG
PG
PG
cI
Nb
Nb
Nb
Nb
Nb
Nb
Nb
PG
IT
Om
Om
Nb
Nb
oF
ks
sY
No
sY
sY
OP
tM
tM
tM
tM
tM
tM
Xp
Xp
Xp
"}
(19,1,1) = {"
Xp
Xp
Xp
Xp
Xp
Xp
Xp
Xp
Xp
PG
AZ
Nb
Nb
Nb
Nb
Nb
Nb
Nb
PG
IT
IT
IT
Om
Nb
Nb
PG
iS
DV
sY
tM
tM
tM
tM
tM
tM
tM
tM
Xp
Xp
Xp
"}
(20,1,1) = {"
Xp
Xp
Xp
Xp
Xp
Xp
Xp
Xp
QA
PG
qq
Nc
Nb
Nb
Nb
Nc
Nb
Nb
PG
PG
PG
PG
PG
Yn
PG
PG
Fh
tM
QQ
tM
jc
sY
tM
tM
tM
tM
tM
tM
Xp
Xp
"}
(21,1,1) = {"
Xp
Xp
Xp
Xp
Xp
Xp
Xp
Xp
Xp
lj
iv
Nb
Nb
DS
Nb
Nb
Nb
Nb
Nb
Nc
Uw
OC
Uw
Nb
Nb
en
uM
eT
oF
sY
OP
tM
tM
tM
tM
tM
tM
tM
Xp
Xp
"}
(22,1,1) = {"
Xp
Xp
Xp
Xp
Xp
Xp
Xp
Xp
Xp
PG
PG
PG
PG
Yn
PG
PG
PG
PG
xT
PG
PG
PG
PG
lW
iS
BF
tM
QQ
IT
tM
tM
tM
tM
tM
tM
tM
tM
tM
Xp
Xp
"}
(23,1,1) = {"
Xp
Xp
Xp
Xp
Xp
Xp
Xp
Xp
Xp
PG
Jd
Nb
Nb
Nb
Nb
zt
zt
Wy
Nb
cI
PG
IT
IT
IT
Nb
pA
sY
sY
sY
tM
tM
tM
tM
tM
tM
tM
tM
tM
tM
Xp
"}
(24,1,1) = {"
Xp
Xp
QA
PG
PG
PG
PG
PG
PG
PG
zt
Nc
Nb
Nb
Nb
Nc
Nb
Nb
Nb
BB
PG
IT
Om
IT
Nb
IX
eo
oF
sY
sY
tM
tM
tM
tM
tM
tM
tM
tM
tM
Xp
"}
(25,1,1) = {"
Xp
Xp
Xp
lj
ce
Uw
Uw
Uw
ce
PG
zt
zt
zt
ck
Nb
Nb
Nb
Nb
Nb
Bm
PG
Ej
bs
zt
Nb
wv
sY
tM
tM
tM
tM
tM
tM
tM
tM
tM
tM
tM
tM
Xp
"}
(26,1,1) = {"
Xp
Xp
Xp
PG
Nb
FC
Nb
Nb
Uw
PG
PG
PG
PG
PG
bl
PG
PG
PG
PG
PG
PG
PG
PG
PG
sY
oF
tf
lF
tM
tM
tM
tM
tM
tM
tM
tM
tM
tM
tM
Xp
"}
(27,1,1) = {"
Xp
Xp
Xp
PG
Nb
Nc
Nb
FC
Uw
Uw
Nb
Nb
Nb
Uw
Nb
vb
PG
tM
tM
tM
tM
tM
tM
tM
tM
tM
sY
tM
tM
tM
tM
tM
tM
tM
tM
tM
tM
tM
tM
Xp
"}
(28,1,1) = {"
Xp
Xp
Xp
PG
Nb
Nb
Nb
Nb
Vw
Uw
Nb
Uw
Nb
ii
Uw
IE
PG
tM
tM
tM
tM
tM
tM
tM
tM
tM
tM
tM
tM
tM
tM
tM
tM
tM
tM
tM
tM
tM
tM
Xp
"}
(29,1,1) = {"
Xp
Xp
QA
PG
FC
Nc
Vw
Nb
Nb
Nc
Nb
Uw
Nb
Uw
Nb
zU
PG
tM
tM
tM
tM
tM
tM
tM
tM
tM
tM
tM
tM
tM
tM
tM
tM
tM
tM
tM
tM
tM
tM
Xp
"}
(30,1,1) = {"
Xp
Xp
Xp
lj
Nb
FC
gB
FC
Uw
Uw
Nb
Uw
Nb
Nb
Nb
PG
PG
tM
tM
tM
tM
tM
tM
tM
tM
tM
tM
tM
tM
tM
tM
tM
tM
tM
tM
tM
tM
tM
tM
Xp
"}
(31,1,1) = {"
Xp
Xp
Xp
PG
PG
nH
nH
nH
PG
PG
PG
PG
PG
PG
PG
PG
tM
tM
tM
tM
tM
tM
tM
tM
tM
tM
tM
tM
tM
tM
tM
tM
tM
tM
tM
tM
tM
tM
Xp
Xp
"}
(32,1,1) = {"
Xp
Xp
Xp
Xp
Xp
Xp
Xp
Xp
Xp
tM
tM
tM
tM
tM
tM
tM
tM
tM
tM
tM
tM
tM
tM
tM
tM
tM
tM
tM
tM
tM
tM
tM
tM
tM
tM
tM
Xp
Xp
Xp
Xp
"}
(33,1,1) = {"
Xp
Xp
Xp
Xp
Xp
Xp
Xp
Xp
tM
tM
tM
tM
tM
tM
tM
tM
tM
tM
tM
tM
tM
tM
tM
tM
tM
tM
tM
tM
tM
tM
tM
tM
tM
tM
tM
Xp
Xp
Xp
Xp
Xp
"}
(34,1,1) = {"
Xp
Xp
Xp
Xp
Xp
Xp
Xp
Xp
tM
tM
tM
tM
tM
tM
tM
tM
tM
tM
tM
tM
tM
tM
tM
tM
tM
tM
tM
tM
Xp
Xp
Xp
Xp
Xp
Xp
Xp
Xp
Xp
Xp
Xp
Xp
"}
(35,1,1) = {"
Xp
Xp
Xp
Xp
Xp
Xp
Xp
Xp
tM
tM
tM
tM
tM
tM
tM
tM
tM
tM
tM
tM
tM
tM
tM
tM
tM
Xp
Xp
Xp
Xp
Xp
Xp
Xp
Xp
Xp
Xp
Xp
Xp
Xp
Xp
Xp
"}
(36,1,1) = {"
Xp
Xp
Xp
Xp
Xp
Xp
Xp
Xp
Xp
tM
tM
tM
tM
tM
tM
tM
tM
tM
tM
Xp
Xp
Xp
Xp
Xp
Xp
Xp
Xp
Xp
Xp
Xp
Xp
Xp
Xp
Xp
Xp
Xp
Xp
Xp
Xp
Xp
"}
(37,1,1) = {"
Xp
Xp
Xp
Xp
Xp
Xp
Xp
Xp
Xp
Xp
tM
tM
tM
tM
tM
tM
tM
tM
Xp
Xp
Xp
Xp
Xp
Xp
Xp
Xp
Xp
Xp
Xp
Xp
Xp
Xp
Xp
Xp
Xp
Xp
Xp
Xp
Xp
Xp
"}
(38,1,1) = {"
Xp
Xp
Xp
Xp
Xp
Xp
Xp
Xp
Xp
Xp
Xp
tM
tM
tM
tM
tM
Xp
Xp
Xp
Xp
Xp
Xp
Xp
Xp
Xp
Xp
Xp
Xp
Xp
Xp
Xp
Xp
Xp
Xp
Xp
Xp
Xp
Xp
Xp
Xp
"}
(39,1,1) = {"
Xp
Xp
Xp
Xp
Xp
Xp
Xp
Xp
Xp
Xp
Xp
Xp
Xp
Xp
Xp
Xp
Xp
Xp
Xp
Xp
Xp
Xp
Xp
Xp
Xp
Xp
Xp
Xp
Xp
Xp
Xp
Xp
Xp
Xp
Xp
Xp
Xp
Xp
Xp
Xp
"}
(40,1,1) = {"
Xp
Xp
Xp
Xp
Xp
Xp
Xp
Xp
Xp
Xp
Xp
Xp
Xp
Xp
Xp
Xp
Xp
Xp
Xp
Xp
Xp
Xp
Xp
Xp
Xp
Xp
Xp
Xp
Xp
Xp
Xp
Xp
Xp
Xp
Xp
Xp
Xp
Xp
Xp
Xp
"}
